NO ./textures/bluestone.xpm
SO ./textures/mossy.xpm
WE ./textures/greystone.xpm
EA ./textures/wood.xpm

F 255,0,0
C 255,255,255

1111111111
10000N0001
1000000001
1000001101
1001001001
1000000001
1000000001
1111111111