NO ./textures/bluestone.xpm
SO ./textures/eagle.xpm
WE ./textures/bluestone.xpm
EA ./textures/bluestone.xpm

F 0,0,0
C 0,0,0

1111111111
1000001001
1000001001
1000001001
1000100001
1000000001
10000N0001
1111111111