NO ./textures/bluestone.xpm
SO ./textures/mossy.xpm
WE ./textures/greystone.xpm
EA ./textures/wood.xpm

F 255,0,0
C 255,255,255

1111111111
1000000001
10000000011111111111
10000011000000000001
10010010011111111111
10001N0001
1000001001
1111111111