NO ./textures/redbrick.xpm
SO ./textures/mossy.xpm
WE ./textures/greystone.xpm
EA ./textures/wood.xpm

F 255,0,0
C 255,255,255

1111111111
1000300001
1000000001
1000001101
1001001201
10000N0201
1030000001
1111111111