11111111111111111111111111111111111
1E0000000000000000000C0000000000001
10100101001000001010010000000010101
10100100101C10100010010000000010101
1P000000000000000000000000000C000C1
11111111111111111111111111111111111