11111111111111111111111111111111111
1P100000000000000100001000010000001
10000101111110010100001110110000101
10111101000010010100000011100010001
10000101000011000111011000100110011
10111100010000000100010000111100001
10100001011111111100010010000000111
10111001000000000100010110001010011
10100C0111111111C110110100111010001
10101000000000010010100100100011111
1C111111000100010010101110100000001
10000001111101010000100111111101001
1000100100010101011111111000000C001
11111001100101011100000000010010001
110000000000010000011000100100100E1
11111111111111111111111111111111111