NO ./textures/wood.xpm
SO ./textures/wood.xpm
WE ./textures/wood.xpm
EA ./textures/wood.xpm

F 0,0,0
C 255,255,255

1111111111
1500300501
1000000001
1400001101
1001001201
10003N0201
1030000001
1111111111