NO ./textures/wood.xpm
SO ./textures/wood.xpm
WE ./textures/wood.xpm
EA ./textures/wood.xpm

F 0,0,0
C 255,255,255

11111111111111111
10000000000000001
100000000111 1111
1000000001
10000000011111111
10000N00000000001
11111111111111111