NO ./textures/wood.xpm
SO ./textures/mossy.xpm
WE ./textures/redbrick.xpm
EA ./textures/bluestone.xpm

F 0,0,0
C 255,255,255

1111111111111111111111111111111111
1E00000000200000000010300005000001        111111111111111111111
1000500000100000000010000000000001        100000000000000000001
1000111111111111000010001111100001        104111111111111111121
10001          100401000100310004111111111121111111111111111101
10001          1121110001011100002000000000010000500001     101
10031          100000000100000000100000003001000000000111111121
121111111111111100051111111111111140000000001000000000000300001
100200000000000000000000000000000000000000001000040000000000001
111111111112111111111100001111111111111111111111111111000000111
          101        130001                         10500001
          101        100001                        10000001
          10111111111100001111111111          111110000041
          10000000000200000000000001111111111114000000001
          11111111111111111111111000000000000020000050001
                                1111111111111111111111111